~~~~~~~~~~~
~.....=...~
~==.......~
~....=====~
~==.......~
~......===~
~=====....~
~~~~~~~~~~~